Tile mapping Version 1.0
#tileset
ressources/tileset.png
ressources/tileset_array_properties
#level
24 32
9 9 9 153 154 155 156 9 9 9 9 9 9 9 9 9 9 9 9 9 162 163 164 165 166 9 9 9 9 153 154 155 
9 9 9 162 163 164 165 166 9 9 9 9 9 9 9 9 9 9 9 9 9 9 9 9 9 9 9 9 9 162 163 164 
9 9 9 9 9 9 9 9 9 9 9 9 9 9 9 9 9 135 144 146 135 9 9 9 9 9 9 9 9 9 9 9 
9 9 9 9 9 9 9 9 9 9 145 9 9 9 9 9 0 1 8 8 6 7 9 9 9 9 9 9 9 9 9 9 
144 9 9 9 9 9 9 9 0 1 8 8 6 7 9 9 9 9 9 9 9 9 9 9 9 9 9 9 9 9 9 144 
16 3 3 5 6 7 9 9 9 9 9 9 9 9 9 9 9 9 9 9 9 9 9 9 9 9 0 1 2 3 4 17 
20 15 15 23 9 9 9 9 9 9 9 9 9 9 39 39 9 9 9 9 9 9 9 9 9 9 9 9 20 15 15 23 
9 9 9 9 9 9 9 9 9 9 9 9 9 9 9 9 9 9 9 9 9 9 9 9 9 9 9 9 9 9 9 9 
9 9 9 9 9 9 9 9 9 9 9 9 9 9 9 9 9 9 9 9 9 9 39 39 9 9 9 9 9 9 9 9 
9 9 9 9 9 9 37 61 42 9 9 9 9 9 9 39 39 9 9 9 9 9 9 9 9 9 9 9 9 9 9 9 
9 9 9 9 9 9 9 9 9 9 9 136 9 135 9 146 9 9 135 9 136 9 9 9 9 9 9 9 9 9 9 9 
0 1 6 7 9 9 9 9 9 9 0 1 8 8 8 8 8 8 8 8 6 7 9 9 9 9 9 9 9 9 9 9 
9 9 9 9 9 9 9 9 9 9 9 9 9 9 9 9 9 9 9 9 9 9 9 9 9 9 9 9 9 9 9 9 
9 9 9 9 9 145 9 9 9 9 9 9 9 9 9 9 9 9 9 9 9 9 9 9 9 9 9 9 9 9 9 9 
9 9 9 9 0 1 6 7 9 9 9 9 9 9 9 9 9 9 9 9 9 9 9 9 9 9 9 9 9 9 9 9 
9 9 9 9 9 9 9 9 9 9 9 9 9 9 9 9 9 9 9 9 9 9 9 9 9 121 122 123 9 9 9 9 
9 9 9 9 9 9 9 9 9 9 9 9 9 9 9 9 9 9 9 9 9 9 9 9 9 130 131 132 9 9 9 9 
121 122 123 9 9 9 9 9 9 9 9 9 9 9 9 9 9 9 9 9 9 9 9 9 145 139 140 141 9 9 9 9 
130 131 132 9 9 9 9 9 9 9 9 9 9 9 136 9 9 9 9 9 9 9 9 0 16 3 3 3 17 7 9 9 
139 140 141 9 9 144 135 9 9 9 9 9 9 0 16 3 3 17 7 9 9 9 9 9 11 22 15 15 23 9 9 9 
16 4 4 4 4 4 17 7 9 9 0 29 7 9 11 12 12 14 9 9 0 29 7 9 11 14 9 9 9 9 9 9 
11 12 12 12 22 15 23 99 99 99 99 99 99 99 11 12 12 14 99 99 99 99 99 99 11 14 9 9 9 9 9 9 
11 12 12 12 14 109 108 109 108 109 109 108 109 109 11 12 12 14 109 109 108 109 108 109 11 14 144 9 9 9 9 9 
11 12 12 12 14 108 109 109 109 108 109 109 109 108 11 12 12 14 108 109 109 109 109 108 11 13 4 3 3 3 3 3 
#end