Tile mapping Version 1.0
#tileset
ressources/tileset.png
ressources/tileset_array_properties.txt
#level
30 40
9 9 9 153 154 155 156 9 9 9 9 9 9 9 9 9 9 9 9 9 9 9 9 9 9 9 9 9 9 9 9 9 9 9 9 9 9 153 154 155 
9 9 9 162 163 164 165 166 9 9 9 9 9 9 9 9 9 9 9 9 9 9 9 9 9 9 9 9 9 9 9 9 9 9 9 9 9 162 163 164 
9 9 9 9 9 9 9 9 9 9 9 9 9 9 9 9 78 79 144 146 72 9 9 9 9 9 9 9 9 9 9 9 9 9 9 9 9 9 9 9 
9 9 9 9 9 9 9 9 9 9 9 9 9 9 9 78 87 1 8 8 6 7 9 9 9 9 9 9 9 9 9 9 9 9 9 9 9 121 122 123 
9 9 9 9 9 9 9 9 9 9 9 9 9 9 78 87 96 9 9 9 9 9 9 9 9 9 9 9 9 9 9 9 9 9 9 9 9 130 131 132 
9 9 9 9 9 9 9 9 9 9 72 83 84 86 87 96 9 9 9 9 9 9 9 9 9 9 9 79 9 72 73 9 9 9 9 78 79 139 140 141 
9 0 1 2 3 3 3 3 4 5 6 92 93 95 96 9 9 9 9 9 9 9 9 9 9 9 0 1 8 6 82 83 84 85 86 87 1 2 4 17 
9 9 9 20 15 15 15 15 15 23 9 9 9 9 9 9 9 9 9 9 9 9 9 9 9 9 9 9 9 9 91 92 93 94 95 96 9 20 15 23 
9 9 9 9 9 9 9 9 9 9 9 9 9 9 9 9 9 9 9 9 9 9 9 9 9 9 9 9 9 9 9 9 9 9 9 9 9 9 9 9 
9 9 9 9 9 9 9 9 9 9 9 9 9 9 9 9 9 9 9 9 9 9 9 9 9 9 9 9 9 9 9 9 9 9 9 9 9 9 9 9 
9 9 9 9 9 9 9 9 9 9 9 9 9 9 9 9 9 9 9 9 9 9 9 9 9 9 9 9 9 9 9 9 9 9 9 9 9 9 9 9 
9 9 9 9 9 9 9 9 9 9 9 9 9 9 9 9 9 9 9 9 9 9 9 9 9 9 9 9 9 9 9 9 9 9 0 37 42 7 9 9 
9 9 9 9 9 9 9 9 9 9 9 9 9 9 128 129 9 9 9 9 9 9 9 9 9 9 9 9 9 9 9 9 9 9 9 9 9 9 9 9 
9 9 9 9 9 17 9 72 83 84 85 86 79 144 137 138 135 136 9 9 9 9 9 135 136 145 9 9 9 9 9 9 9 0 37 42 7 9 9 9 
9 9 9 9 9 15 8 6 92 93 94 95 1 2 4 4 4 5 6 7 9 0 1 8 2 3 17 7 9 9 9 9 9 9 9 9 9 9 9 9 
9 9 9 9 9 9 9 9 9 9 9 9 9 20 15 15 15 23 9 9 9 9 9 9 20 15 21 17 7 9 9 9 0 37 42 7 9 9 9 9 
9 9 9 9 9 9 9 9 9 9 9 9 9 9 9 9 9 9 9 9 9 9 9 9 9 9 9 9 9 9 9 9 9 9 9 9 9 9 9 9 
9 0 37 42 7 9 9 9 9 9 9 9 9 9 9 9 9 9 9 9 9 9 9 9 9 9 0 1 8 6 7 0 37 42 7 9 9 9 9 9 
9 9 9 9 9 9 9 9 9 9 9 9 121 122 123 9 9 9 9 9 9 9 9 9 9 9 9 9 9 9 9 9 9 9 9 9 9 9 9 9 
9 9 9 9 0 37 42 7 9 9 9 9 130 131 132 9 9 9 9 9 9 9 9 9 9 9 9 9 0 1 8 6 7 9 9 121 122 123 9 9 
9 9 9 9 9 9 9 9 9 9 9 146 139 140 141 136 9 9 9 9 9 9 9 9 9 9 9 9 9 9 9 36 37 42 7 130 131 132 9 9 
9 128 129 9 0 37 42 7 9 9 0 16 4 4 4 17 7 9 9 9 9 9 9 144 9 9 135 136 9 145 146 135 9 9 9 139 140 141 9 9 
9 137 138 9 144 9 9 9 9 9 9 11 12 12 22 23 9 9 9 9 9 9 0 16 4 4 4 4 4 4 4 4 4 4 4 4 4 17 7 17 
3 3 3 4 4 4 5 6 7 9 9 11 12 12 14 9 9 9 9 9 9 9 9 11 12 12 12 12 12 12 12 12 12 12 12 12 12 14 9 14 
12 12 12 12 12 12 14 99 99 99 99 11 12 12 14 99 99 99 99 99 99 99 99 11 12 12 12 22 15 15 15 21 12 12 12 12 12 14 9 14 
12 12 12 12 12 12 14 109 108 109 109 11 12 12 14 109 109 109 108 109 109 109 109 11 12 12 12 14 9 9 9 20 15 15 15 15 15 23 9 14 
12 12 22 15 15 15 23 109 109 109 109 11 12 22 23 109 109 108 109 109 108 109 109 20 15 15 21 14 9 9 9 9 9 9 9 9 9 9 9 14 
12 12 14 108 109 109 108 109 109 108 109 11 12 14 109 109 109 109 109 108 109 109 108 109 109 109 11 14 146 9 135 9 135 145 135 135 9 135 9 14 
12 12 14 109 108 109 109 109 108 108 109 11 12 14 108 109 109 109 109 109 109 109 108 109 109 108 11 12 4 4 4 4 4 4 4 4 4 4 4 14 
12 12 14 109 109 108 109 109 108 109 109 11 12 14 109 109 109 108 109 109 109 109 109 109 108 109 11 13 13 12 12 12 12 13 12 12 12 12 12 14 
#end