Tile mapping Version 1.0
#tileset
ressources/tileset.png
ressources/tileset_array_properties
#level
24 32
0 0 0 153 154 155 156 0 0 0 0 0 9 9 9 9 9 9 9 9 9 9 9 9 9 9 0 0 0 0 0 0
0 0 0 162 163 164 165 166 0 0 0 0 9 9 9 9 9 9 9 9 9 9 9 9 9 9 0 0 0 0 0 0
0 0 0 0 0 0 0 0 0 0 0 0 0 0 0 9 9 135 144 146 135 9 9 0 0 0 0 0 0 0 0 0
0 0 0 0 0 0 0 0 0 0 0 0 0 0 0 9 0 1 8 8 6 7 9 0 0 0 0 0 0 0 0 0
0 0 0 0 0 0 0 0 0 0 0 0 0 0 0 9 9 9 9 9 9 9 9 0 0 0 0 0 0 0 0 0
0 0 0 0 0 0 0 0 0 0 0 0 0 0 0 0 0 0 0 0 0 0 0 0 0 0 0 9 9 72 73 9
0 0 0 0 0 0 0 0 9 9 9 0 0 0 0 0 0 0 0 0 0 0 0 0 0 0 0 9 8 6 82 83
0 0 0 0 0 0 0 0 9 9 9 0 0 0 0 0 0 0 0 0 0 0 0 0 0 0 0 9 9 9 91 92
0 0 0 0 0 0 0 0 9 9 9 0 0 0 0 0 0 0 0 0 0 0 0 0 0 0 0 0 0 0 0 0
0 0 0 0 0 0 0 0 0 0 0 0 0 0 0 0 0 0 0 0 0 0 0 0 0 0 0 0 0 0 0 0
0 0 0 0 0 0 0 0 0 0 0 0 0 0 0 0 0 0 0 0 0 0 0 0 0 0 0 0 0 0 0 0
0 0 0 0 0 0 0 0 0 0 0 0 0 0 0 0 0 0 0 0 0 0 0 0 0 0 0 0 0 0 0 0
0 0 0 0 0 0 0 0 0 0 0 0 0 0 128 129 0 0 0 0 0 0 0 0 0 0 0 0 0 0 0 0
0 0 0 0 0 0 0 72 83 84 85 86 79 144 137 138 135 136 0 0 0 0 0 0 0 0 0 0 0 0 0 0
0 0 0 0 0 0 0 6 92 93 94 95 1 2 4 4 4 5 6 7 0 0 0 0 0 0 0 0 0 0 0 0
0 0 0 0 0 0 0 0 0 0 0 0 0 20 15 15 15 23 0 0 0 0 0 0 0 0 0 0 0 0 0 0
0 0 0 0 0 0 0 0 0 0 0 0 0 0 0 0 0 0 0 0 0 0 0 0 0 0 0 0 0 0 0 0
0 0 0 0 0 0 0 0 0 0 0 0 0 0 0 0 0 0 0 0 0 0 0 0 0 0 0 0 0 0 0 0
0 0 0 0 0 0 0 0 0 0 0 0 0 0 0 0 0 0 0 0 0 0 0 0 0 0 0 0 0 0 0 0
0 0 0 0 0 0 0 0 0 0 0 0 0 0 0 0 0 0 0 0 0 0 0 0 0 0 0 0 0 0 0 0
9 9 9 9 9 9 9 9 9 9 9 0 0 0 0 0 0 0 0 0 0 0 0 0 0 0 0 0 0 0 0 0
9 128 129 9 9 9 9 9 9 9 0 16 4 4 4 17 7 9 9 9 9 9 9 144 9 9 135 136 9 145 146 135
9 137 138 9 144 9 9 9 9 9 9 11 12 12 22 23 9 9 9 9 9 9 0 16 4 4 4 4 4 4 4 4
3 3 3 4 4 4 5 6 7 9 9 11 12 12 14 9 9 9 9 9 9 9 9 11 12 12 12 12 12 12 12 12
12 12 12 12 12 12 14 99 99 99 99 11 12 12 14 99 99 99 99 99 99 99 99 11 12 12 12 12 12 12 12 12
12 12 12 12 12 12 14 109 108 109 109 11 12 12 14 109 109 109 108 109 108 109 109 11 12 12 12 12 12 12 12 12
12 12 22 15 15 15 23 109 109 109 109 11 12 22 23 109 109 108 109 109 108 109 109 20 15 15 21 12 12 12 12 12
12 12 14 108 109 109 108 109 109 108 109 11 12 14 109 109 109 109 109 108 109 109 108 109 109 109 11 12 12 12 12 12
12 12 14 109 108 109 109 109 108 108 109 11 12 14 108 109 109 109 109 109 109 109 108 109 109 108 11 12 12 12 12 12
12 12 14 109 109 108 109 109 108 109 109 11 12 14 109 109 109 108 109 109 108 109 109 109 108 109 11 13 13 12 12 12
#end